





                 #########################
                 #··⌄····⋆·┆··········░░▒#
                 #⋆··⋆··⌄··┆··········░░▒#
                 ###########·············#
                         ##########Ξ##########
               ###########···················#####
            ####···················₸·············####
      #######········₸······················₸·······##
   ####···············┌╌╌╌╌╌╔══──═════──══╗··········#
 ###····₸·············┆⌄⋆·⌄·║··▒▒▓⧇·······║···₸······####
 #····················┆⋆·⌄·⋆Ξ··░░░········│·············###
 #····················┆·⌄·⋆·║······θ······║···············## 
 ##···········₸·······└╌╌╌╌╌╚═══────═══Ξ══╝················##
 ##······································θ·················##
 #················₸···············@························##
 ##························₸···············₸·············### 
  ####·················································### 
     ###··········································###### 
       ########·······························##### 
              ##############·············###### 
                  ######················###### 
###################··························################