




···················₸···················
·····₸······················₸··········
···········┌╌╌╌╌╌╔══──═════──══╗·······
·₸·········┆⌄⋆·⌄·║··▒▒▓⧇·······║···₸···
···········┆⋆·⌄·⋆Ξ··░░░········│·······
···········┆·⌄·⋆·║······θ······║·······
······₸····└╌╌╌╌╌╚═══────═══Ξ══╝·······
·····························θ·········
···₸···············@···················
············₸···············₸··········
·······································

